65,65,65,65,65,65,65,65,65,65,65,65,65,65,65,65,65,65,65,65,65,65,65,65,65,65,65,65,65,65,65,65,65,65,65,65,65,65,65,65,
65,0,0,0,65,0,0,0,0,0,0,0,0,0,0,0,0,65,0,0,0,0,65,0,0,0,0,0,0,0,0,0,0,0,0,65,0,0,0,65,
65,0,0,0,65,0,0,0,0,0,0,0,0,0,0,0,0,65,0,0,0,0,65,0,0,0,0,0,0,0,0,0,0,0,0,65,0,0,0,65,
65,0,0,0,65,0,0,0,0,0,0,0,0,0,0,0,0,65,0,0,0,0,65,0,0,0,0,0,0,0,0,0,0,0,0,65,0,0,0,65,
65,0,0,0,65,0,0,0,0,0,0,0,0,0,0,0,0,0,0,0,0,0,0,0,0,0,0,0,0,0,0,0,0,0,0,65,0,0,0,65,
65,0,0,0,65,0,0,0,0,0,0,0,0,0,0,0,0,0,0,0,0,0,0,0,0,0,0,0,0,0,0,0,0,0,0,65,0,0,0,65,
65,0,0,0,65,0,0,0,0,0,0,0,0,0,0,0,0,0,0,0,0,0,0,0,0,0,0,0,0,0,0,0,0,0,0,65,0,0,0,65,
65,0,0,0,65,65,65,65,65,65,65,65,65,65,0,0,0,0,0,0,0,0,0,0,0,0,65,65,65,65,65,65,65,65,65,65,0,0,0,65,
65,0,0,0,0,0,0,0,0,0,0,0,0,65,0,0,0,0,0,0,0,0,0,0,0,0,65,0,0,0,0,0,0,0,0,0,0,0,0,65,
65,0,0,0,0,0,0,0,0,0,0,0,0,65,0,0,0,0,0,0,0,0,0,0,0,0,65,0,0,0,0,0,0,0,0,0,0,0,0,65,
65,0,0,0,0,0,0,0,0,0,0,0,0,65,0,0,0,0,0,0,0,0,0,0,0,0,65,0,0,0,0,0,0,0,0,0,0,0,0,65,
65,0,0,0,0,0,0,0,0,0,0,0,0,65,0,0,0,0,0,0,0,0,0,0,0,0,65,0,0,0,0,0,0,0,0,0,0,0,0,65,
65,0,0,0,0,0,0,0,0,0,0,0,0,65,65,65,65,0,0,0,0,0,0,65,65,65,65,0,0,0,0,0,0,0,0,0,0,0,0,65,
65,65,65,65,65,65,65,65,65,65,65,0,0,0,0,0,0,0,0,0,0,0,0,0,0,0,0,0,0,65,65,65,65,65,65,65,65,65,65,65,
65,0,0,0,0,0,0,0,0,0,65,0,0,0,0,0,0,0,0,0,0,0,0,0,0,0,0,0,0,65,0,0,0,0,0,0,0,0,0,65,
65,0,0,0,0,0,0,0,0,0,65,0,0,0,0,0,0,0,0,0,0,0,0,0,0,0,0,0,0,65,0,0,0,0,0,0,0,0,0,65,
65,0,0,0,0,0,0,0,0,0,65,0,0,0,0,0,0,65,65,65,65,65,65,0,0,0,0,0,0,65,0,0,0,0,0,0,0,0,0,65,
65,0,0,0,0,0,0,0,0,0,65,0,0,0,0,0,0,65,0,0,0,0,65,0,0,0,0,0,0,65,0,0,0,0,0,0,0,0,0,65,
65,0,0,0,0,0,0,0,0,0,65,0,0,0,0,0,0,65,0,0,0,0,65,0,0,0,0,0,0,65,0,0,0,0,0,0,0,0,0,65,
65,0,0,0,0,0,0,0,0,0,65,0,0,0,0,0,0,65,0,0,0,0,65,0,0,0,0,0,0,65,0,0,0,0,0,0,0,0,0,65,
65,0,0,0,0,0,0,0,0,0,65,0,0,0,0,0,0,65,0,0,0,0,65,0,0,0,0,0,0,65,0,0,0,0,0,0,0,0,0,65,
65,0,0,0,0,0,0,0,0,0,65,0,0,0,0,0,0,65,0,0,0,0,65,0,0,0,0,0,0,65,0,0,0,0,0,0,0,0,0,65,
65,65,65,65,65,65,0,0,0,0,65,0,0,0,0,0,0,65,0,0,0,0,65,0,0,0,0,0,0,65,0,0,0,0,65,65,65,65,65,65,
65,0,0,0,0,65,0,0,0,0,0,0,0,0,0,0,0,65,0,0,0,0,65,0,0,0,0,0,0,0,0,0,0,0,65,0,0,0,0,65,
65,0,0,0,0,65,0,0,0,0,0,0,0,0,0,0,0,65,0,0,0,0,65,0,0,0,0,0,0,0,0,0,0,0,65,0,0,0,0,65,
65,0,0,0,0,65,0,0,0,0,0,0,0,0,0,0,0,0,0,0,0,0,0,0,0,0,0,0,0,0,0,0,0,0,65,0,0,0,0,65,
65,0,0,0,0,65,0,0,0,0,0,0,0,0,0,0,0,0,0,0,0,0,0,0,0,0,0,0,0,0,0,0,0,0,65,0,0,0,0,65,
65,0,0,0,0,65,0,0,0,0,0,0,0,0,0,0,0,0,0,0,0,0,0,0,0,0,0,0,0,0,0,0,0,0,65,0,0,0,0,65,
65,0,0,0,0,65,0,0,0,0,0,0,0,65,65,65,0,0,0,0,0,0,0,0,65,65,65,0,0,0,0,0,0,0,65,0,0,0,0,65,
65,0,0,0,0,65,0,0,0,0,0,0,0,0,0,65,0,0,0,0,0,0,0,0,65,0,0,0,0,0,0,0,0,0,65,0,0,0,0,65,
65,0,0,0,0,65,0,0,0,0,0,0,0,0,0,65,0,0,0,0,0,0,0,0,65,0,0,0,0,0,0,0,0,0,65,0,0,0,0,65,
65,0,0,0,0,65,0,0,0,0,0,0,0,0,0,65,0,0,0,0,0,0,0,0,65,0,0,0,0,0,0,0,0,0,65,0,0,0,0,65,
65,0,0,65,65,65,0,0,0,0,0,0,0,0,0,65,65,65,65,65,65,65,65,65,65,0,0,0,0,0,0,0,0,0,65,65,65,0,0,65,
65,0,0,0,0,0,0,0,0,0,0,0,0,0,0,0,0,65,0,0,0,0,65,0,0,0,0,0,0,0,0,0,0,0,0,0,0,0,0,65,
65,0,0,0,0,0,0,0,0,0,0,0,0,0,0,0,0,65,0,0,0,0,65,0,0,0,0,0,0,0,0,0,0,0,0,0,0,0,0,65,
65,0,0,0,0,0,0,0,0,0,0,0,0,0,0,0,0,65,0,0,0,0,65,0,0,0,0,0,0,0,0,0,0,0,0,0,0,0,0,65,
65,0,0,0,0,0,0,0,65,65,0,0,0,0,0,0,0,65,0,0,0,0,65,0,0,0,0,0,0,65,65,0,0,0,0,0,0,0,0,65,
65,0,0,0,0,0,0,0,65,0,0,0,0,0,0,0,0,0,0,0,0,0,0,0,0,0,0,0,0,0,65,0,0,0,0,0,0,0,0,65,
65,0,0,0,0,0,0,0,65,0,0,0,0,0,0,0,0,0,0,0,0,0,0,0,0,0,0,0,0,0,65,0,0,0,0,0,0,0,0,65,
65,65,65,65,65,65,65,65,65,65,65,65,65,65,65,65,65,65,65,65,65,65,65,65,65,65,65,65,65,65,65,65,65,65,65,65,65,65,65,65,hero,20,11,coins,7,8,15,31,16,20,19,36,25,3,24,3,11,35,37,enemies,6,20,22,19,34,37,2,2,3,2,28,37,28,door,19,0,key,19,34